date,doses,doses_first,doses_second,pfizer_cumul,moderna_cumul,astrazeneca_cumul,persons_first_cumul,persons_full_cumul
2020-12-27,24355,24344,11,24349,6,0,24344,11
2020-12-28,18106,18042,64,42455,6,0,42386,75
2020-12-29,50732,50079,652,93186,6,1,92465,727
2020-12-30,64133,64101,32,157319,6,1,156566,759
2020-12-31,50014,49927,87,207333,6,1,206493,846
2021-01-01,25516,25505,10,232839,12,4,231998,857
2021-01-02,48087,48009,78,280926,12,4,280007,935
2021-01-03,22562,22557,5,303486,14,4,302564,940
2021-01-04,46188,46089,99,349646,25,4,348653,1056
2021-01-05,52702,52615,87,402347,26,4,401268,1143
2021-01-06,63162,63076,86,465500,32,7,464344,1229
2021-01-07,54799,54779,20,520291,37,9,519123,1250
2021-01-08,62832,62729,103,583070,88,11,581852,1353
2021-01-09,60739,60594,145,643805,91,12,642446,1498
2021-01-10,35993,35880,113,679788,100,13,678326,1611
2021-01-11,68279,68225,54,748051,114,15,746551,1665
2021-01-12,79141,79079,62,827171,131,18,825630,1728
2021-01-13,112194,111993,201,938186,1310,18,937623,1929
2021-01-14,84125,83912,213,1017150,6471,18,1021535,2142
2021-01-15,91807,90889,918,1103658,11749,37,1112424,3062
2021-01-16,58078,56857,1221,1160047,13436,38,1169281,4284
2021-01-17,47806,30796,17010,1206589,14698,39,1200077,21295
2021-01-18,82988,67375,15613,1285318,18956,40,1267452,36908
2021-01-19,119702,83653,36049,1401202,22723,91,1351105,72957
2021-01-20,132778,79011,53767,1531137,25562,95,1430116,126724
2021-01-21,105542,64619,40922,1633860,28379,97,1494735,167646
2021-01-22,102335,68749,33586,1733990,30571,110,1563484,201232
2021-01-23,87050,40506,46544,1820682,30926,113,1603990,247776
2021-01-24,47825,25689,22136,1868304,31125,117,1629679,269912
2021-01-25,91015,52278,38737,1957865,32576,120,1681957,308649
2021-01-26,98411,50675,47732,2054829,34016,127,1732632,356381
2021-01-27,109428,50946,58482,2162456,35808,135,1783578,414864
2021-01-28,92535,46817,45718,2253359,37437,138,1830395,460582
2021-01-29,107718,49828,57890,2359524,38919,209,1880223,518472
2021-01-30,88112,34616,53496,2446749,39801,212,1914839,571970
2021-01-31,57228,25760,31468,2503594,40179,217,1940599,603438
2021-02-01,120167,58282,61884,2621491,42394,272,1998881,665322
2021-02-02,132822,65538,67284,2751158,45527,294,2064419,732606
2021-02-03,162989,64589,98400,2907724,51924,320,2129008,831006
2021-02-04,134589,62080,72508,3036408,57821,328,2191088,903514
2021-02-05,147563,69376,78187,3177492,64292,336,2260464,981701
2021-02-06,94155,45604,48551,3269013,66925,337,2306068,1030252
2021-02-07,53571,28292,25279,3320246,69260,339,2334360,1055532
2021-02-08,109493,53040,56453,3425871,73097,369,2387400,1111986
2021-02-09,134604,60243,74360,3556844,76541,556,2447643,1186346
2021-02-10,155519,77785,77734,3699677,80833,8949,2525428,1264081
2021-02-11,144561,75558,69003,3820521,88152,25345,2600986,1333086
2021-02-12,156234,80263,75971,3952964,97527,39758,2681249,1409060
2021-02-13,107856,62052,45804,4044138,100793,53173,2743301,1454865
2021-02-14,65465,39630,25835,4099819,103275,60474,2782931,1480701
2021-02-15,125853,70176,55677,4204788,108598,76024,2853107,1536389
2021-02-16,134832,78363,56469,4313707,114815,95719,2931470,1592859
2021-02-17,151872,95424,56448,4436547,122878,116687,3026894,1649308
2021-02-18,144873,91536,53336,4549172,131167,140641,3118430,1702649
2021-02-19,159086,103154,55932,4670559,141209,168297,3221584,1758582
2021-02-20,112502,76174,36328,4757231,145685,189649,3297758,1794912
2021-02-21,86017,57713,28304,4823788,149332,205461,3355471,1823217
2021-02-22,156681,98298,58383,4947400,158407,229454,3453769,1881601
2021-02-23,170591,110005,60586,5081726,165773,258352,3563774,1942188
2021-02-24,177051,117605,59445,5213840,173435,295626,3681379,2001634
2021-02-25,190311,130950,59360,5345802,180226,347184,3812329,2060994
2021-02-26,214059,146417,67641,5487720,189107,410444,3958746,2128635
2021-02-27,148109,108296,39813,5580483,193196,461700,4067042,2168449
2021-02-28,103497,79288,24196,5642136,197161,499577,4146330,2192647
2021-03-01,199392,149368,50024,5773211,206874,558181,4295698,2242671
2021-03-02,220175,167915,52260,5914132,216991,627318,4463613,2294931
2021-03-03,248546,177752,70794,6072762,232177,702048,4641365,2365725
2021-03-04,245912,182563,63348,6214726,246696,791477,4823928,2429073
2021-03-05,275640,208187,67452,6363252,260093,905193,5032115,2496526
2021-03-06,202853,154112,48741,6472704,268958,989729,5186227,2545267
2021-03-07,147887,114359,33528,6552590,275641,1051047,5300586,2578795
2021-03-08,238288,186419,51869,6687029,286631,1143906,5487005,2630664
2021-03-09,253022,198055,54966,6827592,299435,1243561,5685060,2685630
2021-03-10,289950,222483,67465,6987478,311692,1361367,5907543,2753096
2021-03-11,285167,224199,60967,7135478,325472,1484754,6131742,2814063
2021-03-12,327691,256567,71124,7287370,342807,1643218,6388309,2885187
2021-03-13,241278,190883,50395,7403687,352400,1758586,6579192,2935582
2021-03-14,170453,134752,35699,7491941,357922,1835263,6713944,2971281
2021-03-15,248942,189628,59314,7645199,370681,1918188,6903572,3030595
2021-03-16,179528,111201,68327,7812218,381991,1919387,7014773,3098922
2021-03-17,205868,124687,81181,7999271,400054,1920139,7139460,3180103
2021-03-18,194054,118245,75809,8173928,418283,1921307,7257705,3255912
2021-03-19,245909,161240,84668,8360229,439159,1960039,7418945,3340580
2021-03-20,220857,167454,53402,8495905,454508,2029871,7586399,3393982
2021-03-21,164920,126595,38325,8598362,463722,2083119,7712994,3432308
2021-03-22,269973,193245,76725,8765294,487603,2162279,7906239,3509033
2021-03-23,301699,217307,84392,8947487,507386,2262001,8123546,3593426
2021-03-24,340413,250715,89698,9148444,540581,2368260,8374261,3683126
2021-03-25,333933,252561,81371,9334889,568301,2488027,8626822,3764498
2021-03-26,375466,286405,89060,9535408,605660,2625613,8913227,3853560
2021-03-27,281927,219443,62484,9685274,633370,2729962,9132670,3916046
2021-03-28,196768,143428,53340,9800802,651935,2792636,9276098,3969387
2021-03-29,306508,217527,88981,9990032,676965,2884884,9493625,4058368
2021-03-30,329942,236996,92944,10209277,701492,2971054,9730621,4151312
2021-03-31,337796,235855,101940,10458031,737728,3023860,9966476,4253252
2021-04-01,328463,237182,91281,10698542,770255,3079284,10203658,4344534
2021-04-02,226224,158105,68118,10878470,784674,3111161,10361763,4412652
2021-04-03,232501,167820,64681,11053100,800525,3153181,10529583,4477333
2021-04-04,193441,142852,50589,11185661,810602,3203982,10672435,4527924
2021-04-05,248469,178044,70421,11351058,828494,3269162,10850479,4598345
2021-04-06,374345,279441,94899,11606373,860741,3355943,11129920,4693246
2021-04-07,669130,572584,96545,12149225,897873,3445089,11702504,4789791
2021-04-08,700202,612291,87908,12721810,933581,3536997,12314795,4877700
2021-04-09,633417,544263,89154,13213091,970334,3642378,12859058,4966856
2021-04-10,373100,307946,65154,13461837,993604,3743462,13167004,5032010
2021-04-11,264318,213878,50440,13632464,1012299,3818458,13380882,5082450
2021-04-12,419440,342939,76499,13911674,1041585,3929401,13723821,5158950
2021-04-13,577783,503968,73813,14344469,1068933,4047041,14227789,5232763
2021-04-14,776708,693329,83377,14962305,1102541,4172305,14921118,5316140
2021-04-15,682214,611872,70342,15497895,1138805,4282664,15532990,5386483
2021-04-16,598380,523994,74384,15937395,1171494,4408855,16056984,5460867
2021-04-17,366587,309880,56706,16162519,1194214,4527598,16366864,5517573
2021-04-18,269951,230864,39085,16334794,1209632,4609856,16597728,5556658
2021-04-19,403523,341958,61561,16629523,1242627,4685654,16939686,5618220
2021-04-20,562219,499282,62935,17012537,1281948,4825536,17438968,5681157
2021-04-21,722575,649145,73429,17468028,1323706,5050862,18088113,5754586
2021-04-22,639950,572541,67406,17850753,1367428,5264365,18660654,5821992
2021-04-23,557539,488296,69242,18204873,1411081,5424130,19148950,5891235
2021-04-24,366326,307165,59161,18440182,1460496,5505732,19456115,5950396
2021-04-25,283450,234255,49195,18628189,1494226,5567445,19690370,5999591
2021-04-26,434105,359977,74128,18946838,1536785,5640271,20050347,6073790
2021-04-27,786790,695154,91630,19624526,1588364,5697241,20745501,6165973
2021-04-28,1124781,998220,126560,20633934,1649174,5750969,21743721,6293368
2021-04-29,948031,814938,133091,21459552,1713189,5808454,22558659,6427372
2021-04-30,805689,668961,136728,22139350,1770553,5876079,23227620,6565002
2021-05-01,336825,263026,73794,22392490,1812107,5915587,23490646,6641419
2021-05-02,265347,199675,65670,22588299,1849671,5945752,23690321,6708898
2021-05-03,452969,337919,115047,22907043,1920386,6007582,24028240,6825625
2021-05-04,844151,685150,158999,23534239,1983970,6157896,24713390,6987681
2021-05-05,1149059,920434,228624,24387011,2063088,6370467,25633824,7220903
2021-05-06,992968,772916,220048,25081448,2155369,6572087,26406740,7445581
2021-05-07,893062,658447,234611,25670578,2242151,6784739,27065187,7684690
2021-05-08,426487,273842,152643,25938635,2314130,6869462,27339029,7839061
2021-05-09,286592,184983,101609,26132795,2370773,6904182,27524012,7941739
2021-05-10,590573,400453,190116,26506808,2452724,7034897,27924465,8135749
2021-05-11,1087679,802675,285003,27334204,2532834,7211292,28727140,8424530
2021-05-12,1418260,1056375,361883,28429254,2624737,7436763,29783515,8792249
2021-05-13,429762,271367,158393,28744973,2691551,7481323,30054882,8953311
2021-05-14,757690,534789,222900,29291178,2756543,7619969,30589671,9184058
2021-05-15,400889,239406,161481,29570691,2817165,7676440,30829077,9349822
2021-05-16,282552,165552,117000,29770731,2869992,7701394,30994629,9471553
2021-05-17,556417,360015,196398,30109893,2955774,7822968,31354644,9677850
2021-05-18,873232,526072,347157,30700424,3057009,7996572,31880716,10032869
2021-05-19,1099233,576597,522633,31505391,3157350,8178202,32457313,10567797
2021-05-20,949786,467110,482674,32190755,3254003,8334873,32924423,11061569
2021-05-21,852459,418461,433996,32787725,3339993,8492345,33342884,11507592
2021-05-22,474419,229508,244908,33094375,3409601,8576215,33572392,11766791
2021-05-23,285465,133850,151613,33287565,3469082,8600141,33706242,11927272
2021-05-24,326265,149308,176951,33523557,3530628,8620815,33855550,12112276
2021-05-25,656464,297631,358830,33970604,3610584,8725011,34153181,12496371
2021-05-26,1180549,548335,632210,34856209,3693043,8859125,34701516,13206952
2021-05-27,1042248,485802,556441,35596180,3782315,8990865,35187318,13844658
2021-05-28,905370,440828,464540,36200609,3868639,9121515,35628146,14393165
2021-05-29,411040,180024,231011,36463153,3931289,9179541,35808170,14651996
2021-05-30,284031,109025,175005,36660623,3978357,9207948,35917195,14838087
2021-05-31,547885,221422,326463,37028446,4046107,9277720,36138617,15207090
2021-06-01,989691,485086,504462,37762788,4126058,9368426,36623703,15796244
2021-06-02,1249920,622328,627591,38752576,4198777,9450834,37246031,16528840
2021-06-03,643836,284267,359568,39228340,4263230,9501131,37530298,16941730
2021-06-04,812249,369330,442918,39814895,4334591,9578173,37899628,17461939
2021-06-05,413348,127177,286171,40086258,4401637,9622444,38026805,17778778
2021-06-06,292597,77905,214692,40292255,4442691,9649721,38104710,18011739
2021-06-07,615120,248220,366900,40694943,4527977,9722352,38352930,18433154
2021-06-08,1058144,413754,644383,41546005,4603536,9785389,38766684,19146023
2021-06-09,1428621,549115,879501,42726978,4691035,9849517,39315799,20121545
2021-06-10,1195632,497288,698339,43688062,4781078,9905457,39813087,20908449
2021-06-11,1066787,465184,601600,44499455,4870433,9974652,40278271,21606893
2021-06-12,436826,160141,276684,44785126,4942869,10018123,40438412,21918825
2021-06-13,283107,78770,204337,44965030,5006448,10043950,40517182,22136959
2021-06-14,656692,271108,385583,45397507,5107911,10111456,40788290,22577788
2021-06-15,1051062,410165,640897,46199888,5212709,10196212,41198455,23277812
2021-06-16,1386959,546786,840163,47306798,5319388,10293259,41745241,24194298
2021-06-17,1151501,471810,679691,48193941,5423106,10385598,42217051,24942290
2021-06-18,995577,417172,578397,48929556,5517675,10482093,42634223,25589585
2021-06-19,428181,141546,286634,49203146,5600141,10533058,42775769,25897379
2021-06-20,295185,80888,214297,49382154,5671642,10564919,42856657,26124491
2021-06-21,633136,247758,385377,49795295,5769517,10650640,43104415,26546267
2021-06-22,1080756,413594,667159,50642685,5865561,10753536,43518009,27247852
2021-06-23,1339324,527286,812034,51734977,5961817,10869443,44045295,28094755
2021-06-24,1039800,533698,506100,52535735,6049299,10980422,44578993,28641436
2021-06-25,923708,423849,499852,53232233,6125963,11090510,45002842,29181746
2021-06-26,410847,151005,259838,53488023,6195110,11163151,45153847,29454853
2021-06-27,292269,94364,197901,53661133,6253299,11219967,45248211,29656908
2021-06-28,630873,269839,361033,54063313,6343440,11333953,45518050,30042507
2021-06-29,936079,414690,521389,54750795,6436506,11466805,45932740,30586575
2021-06-30,1026311,477612,548693,55523120,6530722,11603553,46410352,31158290
2021-07-01,986278,479173,507098,56269978,6614333,11736455,46889525,31688295
2021-07-02,849959,405108,444848,56923275,6709386,11815790,47294633,32155417
2021-07-03,378221,165316,212899,57179669,6788785,11842962,47459949,32383572
2021-07-04,273632,102360,171267,57361625,6857001,11857504,47562309,32563757
2021-07-05,538125,212987,325130,57750472,6951699,11897126,47775296,32903845
2021-07-06,781638,288915,492718,58371355,7051099,11942519,48064211,33412525
2021-07-07,999691,345690,653994,59204432,7147163,11993903,48409901,34085685
2021-07-08,851817,285291,566515,59892383,7248790,12036615,48695192,34671727
2021-07-09,760486,242265,518209,60489845,7347822,12079907,48937457,35210636
2021-07-10,344228,106408,237815,60718855,7432121,12101039,49043865,35458238
2021-07-11,228308,69914,158389,60864898,7495804,12111322,49113779,35624926
2021-07-12,470260,166834,303414,61217167,7575615,12135378,49280613,35942464
2021-07-13,764985,201657,563314,61849311,7653696,12170108,49482270,36525808
2021-07-14,978900,228530,750361,62685646,7725971,12217329,49710800,37299238
2021-07-15,771097,195456,575634,63324111,7797355,12255927,49906256,37897522
2021-07-16,663017,175129,487875,63868179,7862050,12287933,50081385,38407645
2021-07-17,272945,90351,182586,64043527,7925398,12303600,50171736,38608813
2021-07-18,200637,71830,128802,64179647,7967122,12315074,50243566,38748934
2021-07-19,383321,106991,276319,64478028,8017955,12334886,50350557,39039548
2021-07-20,610691,142014,468650,65003616,8066736,12356843,50492571,39522563
2021-07-21,759095,170311,588778,65679841,8112924,12379635,50662882,40125231
2021-07-22,625307,136371,488917,66229109,8156436,12398511,50799253,40627799
2021-07-23,573642,133220,440400,66723416,8198834,12417083,50932473,41086564
2021-07-24,212298,65456,146820,66878424,8236397,12424826,50997929,41245368
2021-07-25,124686,38389,86291,66962428,8267894,12428104,51036318,41337566
2021-07-26,340009,83804,256188,67238862,8307901,12440526,51120122,41604900
2021-07-27,555951,112362,443537,67719523,8350248,12460447,51232484,42061459
2021-07-28,693622,137311,556179,68328896,8397308,12483808,51369795,42631466
2021-07-29,580659,121191,459341,68831114,8441098,12503675,51490986,43105591
2021-07-30,499689,111714,387789,69251925,8486687,12520846,51602700,43509498
2021-07-31,195632,60504,134943,69393131,8522599,12526862,51663204,43656939
2021-08-01,117530,37097,80262,69477312,8547721,12529180,51700301,43743110
2021-08-02,295061,70948,223959,69718448,8581222,12538310,51771249,43978363
2021-08-03,464260,91087,372943,70118864,8619784,12550264,51862336,44364634
2021-08-04,575549,111742,463542,70633619,8656463,12561533,51974078,44841022
2021-08-05,520179,100937,419017,71091483,8696312,12569523,52075015,45274515
2021-08-06,442474,97119,345100,71475423,8732245,12576847,52172134,45634892
2021-08-07,185604,54561,130866,71614565,8764155,12578390,52226695,45778767
2021-08-08,116306,27806,88358,71704151,8785953,12579309,52254501,45871128
2021-08-09,295569,61026,234253,71943727,8827590,12584645,52315527,46114401
2021-08-10,431737,86322,345212,72313491,8870334,12592525,52401849,46470962
2021-08-11,544242,120909,423010,72785022,8917589,12602227,52522758,46909726
2021-08-12,474794,119951,354485,73195611,8956058,12609206,52642709,47282968
2021-08-13,425375,115840,309136,73553589,8997259,12615721,52758549,47611785
2021-08-14,195883,67218,128393,73700117,9029625,12617092,52825767,47755796
2021-08-15,118452,38640,79626,73789523,9050472,12617778,52864407,47842935
2021-08-16,266327,82925,183164,74006169,9083654,12620615,52947332,48039761
2021-08-17,362502,113877,248378,74317786,9113368,12626401,53061209,48303524
2021-08-18,423846,137225,286306,74686984,9143748,12632456,53198434,48608043
2021-08-19,335167,121014,213779,74973114,9170093,12637000,53319448,48839970
2021-08-20,342932,132506,209972,75265385,9194029,12642173,53451954,49071494
2021-08-21,156616,73537,82720,75386076,9215099,12642898,53525491,49168344
2021-08-22,94251,40157,53741,75458592,9230613,12643177,53565648,49228027
2021-08-23,233258,91956,140963,75645456,9259744,12646800,53657604,49382630
2021-08-24,298281,121816,175980,75897670,9285620,12650674,53779420,49574927
2021-08-25,342720,141434,200744,76193567,9310547,12654423,53920854,49793818
2021-08-26,300958,133592,166758,76451069,9332698,12657564,54054446,49978740
2021-08-27,253449,114233,137989,76660971,9355108,12660063,54168679,50135367
2021-08-28,137572,70815,65941,76767815,9370453,12660589,54239494,50216165
2021-08-29,85453,37583,47096,76838239,9378871,12660744,54277077,50269717
2021-08-30,192411,84878,105379,76998710,9396005,12662634,54361955,50388012
2021-08-31,243644,111530,128450,77210795,9411824,12664296,54473485,50530540
2021-09-01,296121,125793,154628,77473862,9427530,12666739,54599278,50700073
2021-09-02,258016,112910,127839,77702639,9440581,12668685,54712188,50842154
2021-09-03,247545,107024,124156,77921214,9452807,12670479,54819212,50981260
2021-09-04,108206,48737,54812,78010700,9461332,12670809,54867949,51045937
2021-09-05,64730,28499,32890,78064395,9466989,12670989,54896448,51084025
2021-09-06,155397,64388,75814,78199479,9476717,12672830,54960836,51168583
2021-09-07,223495,92715,107873,78400810,9485992,12674789,55053551,51287386
2021-09-08,260878,104903,128932,78636012,9498131,12676084,55158454,51428560
2021-09-09,255989,103817,123421,78866250,9509496,12677239,55262271,51565212
2021-09-10,227833,89644,116351,79064783,9521968,12678544,55351915,51697086
2021-09-11,110571,44038,60336,79155453,9530751,12678717,55395953,51768367
2021-09-12,64790,23952,36265,79209738,9535888,12678795,55419905,51809922
2021-09-13,167168,63791,82310,79354115,9546032,12679762,55483696,51903912
2021-09-14,237498,93252,111046,79568686,9554363,12681629,55576948,52027687
2021-09-15,284472,104829,138499,79826109,9565726,12682877,55681777,52180624
2021-09-16,276489,106243,128013,80075964,9575677,12684436,55788020,52323761
2021-09-17,249295,94240,123427,80297190,9586648,12685341,55882260,52463381
2021-09-18,112708,41830,62964,80392175,9594254,12685580,55924090,52536223
2021-09-19,69593,24779,39311,80451037,9600080,12685797,55948869,52580222
2021-09-20,158536,52827,80626,80591409,9607922,12686740,56001696,52670227
2021-09-21,234503,79756,112196,80806610,9615831,12687778,56081452,52792778
2021-09-22,275611,90497,132280,81059907,9625754,12688641,56171949,52936586
2021-09-23,268723,90985,124774,81307147,9634135,12689387,56262934,53073716
2021-09-24,241263,81444,121518,81524292,9643742,12690459,56344378,53208673
2021-09-25,100426,33193,58175,81609941,9650010,12690543,56377571,53275273
2021-09-26,56694,17966,32800,81658610,9653835,12690575,56395537,53312241
2021-09-27,151975,49492,74411,81795140,9660097,12691555,56445029,53394855
2021-09-28,223925,73566,103424,82002905,9665880,12692321,56518595,53507890
2021-09-29,251795,78278,118339,82237850,9671535,12693672,56596873,53636073
2021-09-30,244467,78419,116236,82465288,9677410,12694931,56675292,53762204
2021-10-01,127217,43979,59310,82583366,9680338,12695166,56719271,53827490
2021-10-02,31940,13629,14910,82610255,9682137,12695235,56732900,53845583
2021-10-03,13883,5414,6745,82621910,9683277,12695268,56738314,53853383
2021-10-04,95441,32167,43428,82708256,9686735,12696000,56770481,53901716
2021-10-05,182323,55102,84711,82880779,9690218,12696848,56825583,53991896
2021-10-06,204249,58286,92950,83074635,9694241,12697214,56883869,54090850
2021-10-07,211292,62366,96673,83274559,9698491,12697462,56946235,54194393
2021-10-08,182391,57800,81901,83444490,9702758,12698919,57004035,54283030
2021-10-09,40690,16195,19223,83479549,9705111,12698946,57020230,54305504
2021-10-10,17193,6765,7992,83494468,9705990,12698957,57026995,54314880
2021-10-11,95527,29616,41615,83582280,9709399,12699438,57056611,54360320
2021-10-12,178864,50009,77411,83750558,9714438,12700221,57106620,54442495
2021-10-13,205275,55178,87305,83945604,9719636,12700465,57161798,54534587
2021-10-14,207640,55527,89790,84142568,9724936,12700686,57217325,54629532
2021-10-15,170207,48273,74038,84301810,9730279,12701064,57265598,54708814
2021-10-16,41383,15419,19392,84337955,9732822,12701102,57281017,54730863
2021-10-17,16749,5807,7582,84351479,9734987,12701133,57286824,54739474
2021-10-18,91916,25587,36747,84436650,9738630,12701250,57312411,54779206
2021-10-19,177178,45111,73017,84604679,9743567,12701465,57357522,54856220
2021-10-20,203694,48815,80601,84799341,9748310,12701622,57406337,54940953
2021-10-21,205571,49699,80482,84996031,9752846,12701824,57456036,55025578
2021-10-22,159348,40895,62744,85146000,9757794,12702083,57496931,55092494
2021-10-23,43817,14971,17504,85184527,9760795,12702146,57511902,55112224
2021-10-24,14488,4723,5775,85197454,9761536,12702153,57516625,55118812
2021-10-25,106916,27675,39262,85297079,9765213,12702862,57544300,55160979
2021-10-26,208395,44435,75017,85496350,9770166,12703337,57588735,55239692
2021-10-27,240609,48439,82007,85727005,9776661,12703477,57637174,55325018
2021-10-28,247060,50576,81928,85963114,9782683,12704744,57687750,55410608
2021-10-29,205373,44066,66233,86157239,9789442,12705427,57731816,55480647
2021-10-30,51725,15454,16735,86203229,9792946,12705589,57747270,55499451
2021-10-31,15937,4606,5120,86217644,9793849,12705593,57751876,55505186
2021-11-01,63287,13273,18487,86275884,9797151,12705821,57765149,55525190
2021-11-02,212505,37647,60538,86479075,9803541,12706378,57802796,55588095
2021-11-03,289348,51993,74257,86754069,9811593,12708616,57854789,55666416
2021-11-04,297879,51429,74772,87040386,9819338,12708894,57906218,55744727
2021-11-05,252778,44868,58275,87280375,9827993,12709023,57951086,55807007
2021-11-06,68848,17989,15406,87341251,9833187,12709052,57969075,55825162
2021-11-07,32091,8001,7579,87369934,9835380,12709064,57977076,55833944
2021-11-08,170939,30953,35112,87530480,9842146,12709589,58008029,55872158
2021-11-09,336004,55698,68451,87851335,9851748,12710631,58063727,55945114
2021-11-10,393600,59218,70922,88229891,9862014,12711027,58122945,56020418
2021-11-11,407266,63253,73691,88619983,9874085,12711696,58186198,56098543
2021-11-12,322613,53828,51641,88927030,9884670,12711994,58240026,56154867
2021-11-13,98029,24469,16361,89017051,9889721,12712016,58264495,56174163
2021-11-14,47005,10754,8208,89060578,9892224,12712087,58275249,56183275
2021-11-15,235550,40983,36422,89283522,9900961,12712632,58316232,56223021
2021-11-16,459895,61398,63310,89727092,9912770,12713091,58377630,56290388
2021-11-17,526663,65076,63820,90234821,9927593,12713164,58442706,56358246
2021-11-18,522619,64549,65315,90737811,9942772,12713611,58507255,56427564
